##########
##...#..E#
##.#.#.#.#
#..#...#.#
####.#.#.#
##.....#.#
##.#####.#
##.#.....#
##.#.###.#
#S...#...#
##########
